NO ./assets/colorstone.xpm
SO ./assets/eagle.xpm
WE ./assets/mossy.xpm
EA ./assets/greystone.xpm
F 105,105,105
C 25,25,112

1111111111111
1001000000001
1S00011111001
1000110000001
1111111111111
